[
    [
        ["--------------------------------------------------",
         "-                                                -",
         "-                                                -",
         "-              !!!                               -",
         "-              !!!!!!                            -",
         "-               !!!!!                            -",
         "-               !!!!!                            -",
         "-                                                -",
         "-                                       n        -",
         "-                                                -",
         "-           $                                    -",
         "-                                                -",
         "-                                m               -",
         "-                                          e     -",
         "-                                                -",
         "-                                                -",
         "-                                        n       -",
         "-                                                -",
         "-                                                -",
         "-                     n                          -",
         "-                                                -",
         "-                                                -",
         "--------------------------------------------------"],
         [
            ["pikachu", "images/pikachu.png", 90, 100, [[0, 15], [10, 0]]],
            ["bulbasaur", "images/bulbasaur.png", 50, 100, [[0, 10], [15, 0]]]
        ]
    ],
    [
        ["--------------------------------------------------",
         "-                   -      -       !!!!!!        -",
         "-                   -  $   -        !!!!!        -",
         "-                   -      -        !!!!!!       -",
         "-                   -      -        !!!!!!!      -",
         "-                   -      -                     -",
         "-                   -      -                     -",
         "-                   -      -                     -",
         "-                   -                   n        -",
         "-                   -                            -",
         "-                   -                            -",
         "-                   -      -                     -",
         "-                          -                   e -",
         "-                          -                     -",
         "-                          -                     -",
         "-                   -      -                     -",
         "-                   -      -             n       -",
         "-                   -      -                     -",
         "-                   -      -                     -",
         "-                   -      -                     -",
         "-            n      -  m   -                     -",
         "-                   -      -                     -",
         "--------------------------------------------------"],
         [
            ["dragon", "images/dragon.png", 10, 100, [[0, 15], [15, 0]]],
            ["gengar", "images/gengar.png", 80, 100, [[0, 20], [25, 0]]]
        ]
    ],
    [
        ["--------------------------------------------------",
         "-                -!!!!!!!!!!!!!!!!!!!!!!!!!!!!!!!-",
         "-                -!!!!!!!!!!!!!!!!!!!!!!!!!!!!!!!-",
         "-                -!!!!!!!!!!!!!!!!!!!!!!!!!!!!!!!-",
         "-                -!!!!!!!!!!!!!!!!!!!!!!!!!!!!!!!-",
         "-                -!!!!!!!!!               !!!!!!!-",
         "-                -!!!!!!!!                  !!!!!-",
         "-                -!!!!!!                         -",
         "-                -                               -",
         "-                -     n                         -",
         "-                --------------       ------------",
         "-                                                -",
         "-                                                -",
         "-   n                                           e-",
         "-                                                -",
         "-                                       n        -",
         "----------       --------------      -------------",
         "-                      -                         -",
         "-                      -    n                    -",
         "-      $               -               m         -",
         "-                      -                         -",
         "-                      -                         -",
         "--------------------------------------------------"],
         [
            ["umbreon", "images/umbreon.png", 90, 100, [[0, 30], [35, 0]]],
            ["eevee", "images/eevee.png", 80, 100, [[0, 35], [30, 0]]]
        ]
    ],
    [
        ["--------------------------------------------------",
         "-           -!!!!!!!!!!!!!!!!!!!!!!!!!!!!     n  -",
         "-           -!!!!!!!!!!!!!!!!!!!!!!!             -",
         "-           -----------------------------------  -",
         "-           -                                    -",
         "-           -                                   e-",
         "-           -  ----      -----------------       -",
         "-           -     -              -n              -",
         "-           -     -              -               -",
         "-           ----  -------------  -  --------------",
         "-                 -              -               -",
         "-                 -              -               -",
         "-           ----------  -----------------------  -",
         "-           -                       -            -",
         "-           - n                     -            -",
         "-           ----------------------  -  -----------",
         "            -  $                    -  -        n-",
         "-           -                       -  -         -",
         "-           -------------------------  -         -",
         "-           -                          -         -",
         "-           -  m                                 -",
         "-           -                                    -",
         "--------------------------------------------------"],
         [
            ["charizard", "images/charizard.png", 80, 100, [[0, 40], [45, 0]]],
            ["turtle", "images/turtle.png", 60, 100, [[0, 40], [45, 0]]]
        ]
    ]
]